wrk,100,+0000,+0000,+0000,end
wrk,100,+0000,+0000,+0900,end
wrk,100,+1000,+0000,+0000,end
wrk,100,+2000,+0000,+0000,end
wrk,100,+3000,+0000,+0000,end
wrk,100,+4000,+0000,+0000,end
wrk,100,-1000,+0000,+0000,end
wrk,100,-2000,+0000,+0000,end
wrk,100,-3000,+0000,+0000,end
wrk,100,-4000,+0000,+0000,end

vel,100,+1000,+1000,+1000,+1000,end
vel,100,+0000,+0000,+0000,+0000,end



vel,100,+1500,+0500,end
